{
  "2026-04-08": {
    "reading": {
      "main": {
        "21": "B",
        "22": "A",
        "23": "B",
        "24": "C",
        "25": "C",
        "26": "A",
        "27": "D",
        "28": "B",
        "29": "A",
        "30": "B",
        "31": "C",
        "32": "D",
        "33": "B",
        "34": "B",
        "35": "D"
      },
      "extra": {
        "11": "B",
        "12": "C",
        "13": "C",
        "14": "B",
        "15": "A"
      }
    },
    "listening": {
      "main": {
        "1": "A",
        "2": "D",
        "3": "C",
        "4": "C",
        "5": "C",
        "6": "D",
        "7": "C",
        "8": "D",
        "9": "C",
        "10": "C",
        "11": "C",
        "12": "D",
        "13": "C",
        "14": "B",
        "15": "C",
        "16": "D",
        "17": "A",
        "18": "D",
        "19": "C",
        "20": "D",
        "21": "B",
        "22": "C",
        "23": "C",
        "24": "D",
        "25": "C",
        "26": "A",
        "27": "B",
        "28": "C",
        "29": "A",
        "30": "A",
        "31": "B",
        "32": "D"
      },
      "extra": {
        "1": "A",
        "2": "D",
        "3": "B",
        "4": "C",
        "5": "A",
        "6": "C",
        "7": "A",
        "8": "D",
        "9": "A",
        "10": "B",
        "11": "D",
        "12": "D",
        "13": "D",
        "14": "B",
        "15": "D"
      }
    }
  },
  "2026-04-01": {
    "reading": {
      "main": {
        "21": "C",
        "22": "C",
        "23": "A",
        "24": "B",
        "25": "C",
        "26": "B",
        "27": "C",
        "28": "A",
        "29": "C",
        "30": "B",
        "31": "D",
        "32": "D",
        "33": "B",
        "34": "B",
        "35": "A"
      },
      "extra": {
        "11": "A",
        "12": "D",
        "13": "B",
        "14": "C",
        "15": "B"
      }
    },
    "listening": {
      "main": {
        "1": "A",
        "2": "C",
        "3": "C",
        "4": "C",
        "5": "A",
        "6": "C",
        "7": "D",
        "8": "B",
        "9": "B",
        "10": "D",
        "11": "B",
        "12": "D",
        "13": "D",
        "14": "C",
        "15": "C",
        "16": "D",
        "17": "C",
        "18": "A",
        "19": "C",
        "20": "D",
        "21": "C",
        "22": "D",
        "23": "D",
        "24": "A",
        "25": "D",
        "26": "C",
        "27": "A",
        "28": "B",
        "29": "C",
        "30": "B",
        "31": "D",
        "32": "A"
      },
      "extra": {
        "1": "B",
        "2": "C",
        "3": "D",
        "4": "B",
        "5": "B",
        "6": "C",
        "7": "A",
        "8": "C",
        "9": "A",
        "10": "D",
        "11": "B",
        "12": "C",
        "13": "D",
        "14": "C",
        "15": "D"
      }
    }
  },
  "2026-03-27": {
    "reading": {
      "main": {
        "21": "B",
        "22": "C",
        "23": "C",
        "24": "D",
        "25": "C",
        "26": "D",
        "27": "A",
        "28": "B",
        "29": "D",
        "30": "B",
        "31": "B",
        "32": "A",
        "33": "C",
        "34": "A",
        "35": "C"
      },
      "extra": {
        "11": "B",
        "12": "D",
        "13": "A",
        "14": "C",
        "15": "C"
      }
    },
    "listening": {
      "main": {
        "1": "A",
        "2": "A",
        "3": "D",
        "4": "C",
        "5": "C",
        "6": "A",
        "7": "A",
        "8": "A",
        "9": "B",
        "10": "D",
        "11": "B",
        "12": "B",
        "13": "C",
        "14": "D",
        "15": "A",
        "16": "D",
        "17": "B",
        "18": "C",
        "19": "B",
        "20": "D",
        "21": "D",
        "22": "A",
        "23": "D",
        "24": "A",
        "25": "D",
        "26": "A",
        "27": "A",
        "28": "C",
        "29": "B",
        "30": "B",
        "31": "D",
        "32": "A"
      },
      "extra": {
        "1": "A",
        "2": "D",
        "3": "B",
        "4": "B",
        "5": "A",
        "6": "B",
        "7": "A",
        "8": "D",
        "9": "A",
        "10": "B",
        "11": "B",
        "12": "D",
        "13": "A",
        "14": "D",
        "15": "A"
      }
    }
  }
}
